0111111111111
00010000000C1
0000011111001
0P0011E000001
0111111111111
